%%%%%%%%%%%%%%%%%%%%
%        %        P%
%%%%%%%%%% %%%%%%%%%
%.                 %
%%%%%%%%%%%%%%%%%%%%