%%%%%%%%%%%%%%%%%%%%%%
%                   P%
% %%%%%%%%%%%%%%%%%% %
%                    %
% %%%%%%%%%%%%%%%%%% %
%                    %
% %%%%%%%%%%%%%%%%%% %
%.                   %
%%%%%%%%%%%%%%%%%%%%%%