%%%%%%%%%%%%%%%%%%%%%%%%%
%                       %
%                       %
%         %%%           %
%       %%% %%%         %
%      %%     %%        %
%      %   %   %        %
%      %%     %%        %
%       %%% %%%         %
%         %%%           %
%          %            %
%          %%           %
%          %%           %
%.         %           P%
%%%%%%%%%%%%%%%%%%%%%%%%%